6 6
0	0	0	0	0	0
2	1	4	5	0	0
1	0	0	3	0	0
3	0	0	0	0	2
0	4	0	0	5	6
0	0	0	6	0	0
