6 5
2	0	3	0	0	0
1	0	0	5	0	0
0	1	2	4	0	0
0	0	0	0	0	0
0	0	0	0	0	0
4	5	3	0	0	0
